P_P_P_P_P_P_P_P_P_P
_B_B_B_B_B_B_B_B_B_
__G_G_G_G_G_G_G_G__
___Y_Y_Y_Y_Y_Y_Y___
____W_W_W_W_W_W____
_____P_P_P_P_P_____
______B_B_B_B______
_______Y_Y_Y_______
________W_W________
_________P_________
___________________
___________________
___________________
___________________
___________________
___________________
___________________
___________________
___________________
___________________