BBBBBBBBBBBBBBBBBBBB
PPPPPPPPPPPPPPPPPPPP
GGGGGGGGGGGGGGGGGGGG
YYYYYYYYYYYYYYYYYYYY
WWWWWWWWWWWWWWWWWWWW
____________________
____________________
G_G_G_G_G_G_G_G_G_G_
_B_B_B_B_B_B_B_B_B_B
P_P_P_P_P_P_P_P_P_P_
____________________
____________________
____________________
WWWWWWWWWWWWWWWWWWWW
YYYYYYYYYYYYYYYYYYYY
____________________
____________________
____________________
____________________
____________________
