P_P_P_P_P_P_P_P_P_P_
_G_G_G_G_G_G_G_G_G_G
B_B_B_B_B_B_B_B_B_B_
_Y_Y_Y_Y_Y_Y_Y_Y_Y_Y
G_G_G_G_G_G_G_G_G_G_
____________________
____________________
____________________
____________________
____________________
____________________
____________________
____________________
____________________
____________________
____________________
____________________
____________________
____________________
