BBBBBBBBBBBBBBBBBBBB
PPPPPPPPPPPPPPPPPPPP
GGGGGGGGGGGGGGGGGGGG
YYYYYYYYYYYYYYYYYYYY
WWWWWWWWWWWWWWWWWWWW
____________________
____________________
____________________
____________________
____________________
____________________
____________________
____________________
____________________
____________________
____________________
____________________
____________________
____________________
____________________